20 10 2
10.ox
....................
..................o.
o.........o....o....
..............o.....
....................
.o..o...............
.....o.......o.....o
.........o..o.o.....
...............o..oo
...o....o.......o...
