10 20 5
20.ox
..........
..........
..........
.o......o.
..........
.oo......o
.........o
.o..o.....
..........
..........
......o..o
..........
.....o....
...o......
....o.....
...ooo....
....oo...o
..........
....ooooo.
......oo..
